1111111111111111111
1P000C000000000C001
1011111011111011101
1C000001000001000C1
1110111111111110111
1000100C0000C000001
1110110011111010111
1C00001C0E0C0000C01
1011111010101011101
1C000C0010101000C01
1111111111111111111