1111111111111111111111
1000000C0000000CE00001
1011111011111110111101
10C00010000000000000C1
1010111011111110110011
100010000C0000C0000101
1110101111011011101001
1000101000010000100001
1011111111111111111101
10CCCCCCCCCCP0000000C1
1111111111111111111111