11111111111111111111111111111111
10000000000000000000000000000001
10011100010000100111110001111101
1010001001C00C100110C0000110C001
1010E0C0010000100001100000011001
1010001001C00C1000C0110000C01101
10011100011111100111110001111101
10000000000000000000000000000001
1110011111111111P111111111100111
10000000000000000000000000000001
10000011000001100011000001100001
10000100100001010101000010010001
10001000010001C010C1000100001001
100111CC11100100000100111CC11101
10100000000101000001010000000011
10000000000000000000000000000001
11111111111111111111111111111111