1111111111111111111111111111111111111111
1P000000000000000000000000000000000000C1
1000000000000000000000000000000000000011
1C000000000000000000000000000000000000E1
1000000000000000000000000000000000000011
1000000000000000000000000000000000000011
1000000000000000000000000000000000000011
1000000000000000000000000000000000000011
1000000000000000000000000000000000000011
1000000000000000000000000000000000000011
1000000000000000000000000000000000000011
1000000000000000000000000000000000000011
1000000000000000000000000000000000000011
1000000000000000000000000000000000000011
1000000000000000000000000000000000000011
1000000000000000000000000000000000000011
1000000000000000000000000000000000000011
1000000000000000000000000000000000000011
1000000000000000000000000000000000000011
1111111111111111111111111111111111111111