111111111111111111
100000000000000001
1E000000000000P001
1CCCCCCCCCCCCCCCC1
111111111111111111