111111111111111111
1C010000000000E001
100111111111110111
111111111111110111
10000000000000P001
100000000000000001
111111111111111111