11111111111111111111
1111PCE1111111111111
11111111111111111111