11111111111111111111
1001PC11000000000111
10100000000111111011
101001100001111E1011
10011000000011110101
10111100C00011H10101
11111111111111111111