11111111111111111111
1001PCE1000000000111
10100000000111101011
10100110000111101011
10011000000011110101
10111100C00011110101
11111111111111111111