11111111111111111111
1000000000000P000001
10000000E00000000001
10000000C000000C0001
11111111111111111111