11111111111111111111
100CP011000000000011
10100000000111111011
101001100001111E0011
1001100000C011110101
10111100C00011110101
11111111111111111111