11111111111111111111
1P0E000C000000000001
11111111111111111111