11111111111111111111
1PCC000C000000E10001
11111111111111111111