1111111111111111111111111
1000000C0000000CE00001111
1011111011111110111101111
10C00010000000000000C1111
1010111011111110110011111
100010000C0000C0000101111
1110101111011011101001111
1000101000010000100001111
1011111111111111111101111
10CCCCCCCCCCP0000000C1111
1111111111111111111111111